11111
1P0C1
1C0C1
100E1
11111
